ATTGAACATAAACTTTTTATGGAATTACGGA	falciparum
AGAGCTTATTTTACTTCGACTACCATTTTAA	falciparum
ATTCCTTTTAGGAATAATATTTTTTATTCAA	falciparum
ATTTTTATTATCAGTAATACTACGTACTGAA	falciparum
AGGAATAATATTTTTTATTCAAATTATAACA	falciparum
TATTTGTACTTGTTCATTATAGACGAACACA	falciparum
AACATTTATTCTGGTTTTTTGGACATCCTGA	falciparum
CCTTTTTCTATAAATACTTGTAAACATGCAG	falciparum
AATATTTTTTATTCAAATTATAACAGGTGTA	falciparum
AATTGTTAAGATTAACATTCTTGATGAAGTA	falciparum
AATTTCTTTGGTAAAAACTTACGTGAAAATT	falciparum
AACACTACCGGTTTTAACTGGAGGAGTATTA	falciparum
TACTTATCGATAAATGTTCGGTATTGCATGC	falciparum
ATGGATTGGATGTCAATTACCACAAGATATA	falciparum
GAGGTACTACTGGAGTTATATTAGGTAATGC	falciparum
ATAGATAACATACCAGAAGTTAAAGATGAAA	falciparum
AAAATGTAATCCTGTAACACAATAAAATAAT	falciparum
ATATAATGATGTTAATGCAGGATATGAAACT	falciparum
ACAATAAAACGATTTTTTGTACTACATTTTA	falciparum
TATTATTAATAATAATAAACCTATTACTACA	falciparum
ATTTATATCTACCATTATCATGGATATCAGG	knowlesi
TCATTTTCACTTTGTATTATCTATAGGTGCA	knowlesi
TGAAAATTCTATAATTATACTATGGTCAATC	knowlesi
AAATGAGTTATTGGGGTGCAACTGTCATAAC	knowlesi
AAAAATATTATGTTGTTGGTTTAAGCCCTTT	knowlesi
AATTGCACAAGAAAATGTTAATTTATACAAT	knowlesi
ATTCTATATCAACATCTATTCTGGTTCTTTG	knowlesi
AACACAATAAAATAATGTACCTGATATAGCA	knowlesi
CGTGAAAATTCTATAATTATACTATGGTCAA	knowlesi
CTATATCAACATCTATTCTGGTTCTTTGGAC	knowlesi
GAAATTTCTTACGCATACTACAGTATACAAC	knowlesi
AAAATATTATGTTGTTGGTTTAAGCCCTTTT	knowlesi
ACAGGAGTAATATTAGGAAATGCAGCTATTG	knowlesi
ATAAAGATGTTAATGAAGGATAAGATACTAA	knowlesi
ACTTTATTTGGGTTTTTAATTTTTAAATAAT	knowlesi
CAGAAGTATGTAATAAATAATAATGCTTCAG	knowlesi
ATCTACCATTATCATGGATATCAGGATTAAT	knowlesi
AACATTTACGTGAAAATTCTATAATTATACT	knowlesi
ATGTTATTATTGACATTACCTGTATTAACAG	knowlesi
ATTCGGTAATTATTTTCTACCAATTTTATGC	knowlesi
AATAAGTCATTTTCAAGAAAACTTTTTTGGT	malariae_brasilianum
ATGATAAAATATATATGAAATATACTAGCAT	malariae_brasilianum
AAATTCAATTATTGTATTATGGTCAATTTTA	malariae_brasilianum
TAATGTTATTATCTGATCTACATTTTAATAC	malariae_brasilianum
ACCAGATACTAATGAAGAAAATGTGGAATAA	malariae_brasilianum
TATAAATATAATACTTGATATTTCAAAACTC	malariae_brasilianum
ATTAAATGTAAACTTTTAGCCCAAAAGAATA	malariae_brasilianum
AATAATAATAAACCAATAATAACATGTGAAA	malariae_brasilianum
AAATATCTATCATTCTTATAAAGTATATTAA	malariae_brasilianum
AAAATTAACATTCTTGATGAAGTTAATATAA	malariae_brasilianum
ATATATTATAAATATAATACTTGATATTTCA	malariae_brasilianum
ATGATACATATTATGTAATTGCTCACTTTCA	malariae_brasilianum
AAATGTAAATATTCAGTTGTCTGTAATGATG	malariae_brasilianum
TTCATTACTACTATAATGCATTTAAGATCAA	malariae_brasilianum
AATTTATTTTTTTTGTTTTAAATAGATATAC	malariae_brasilianum
ATAGGTTATGTTTTACCATGGGGACAAATGA	malariae_brasilianum
ACTGTATGGACGAAACCTCCAGGCAAAGAAA	malariae_brasilianum
TACTACTATAATGCATTTAAGATCAAAAGGA	malariae_brasilianum
TTGGTATAACTCATAGTTCATCTTTATTAGC	malariae_brasilianum
TGGAATAAAAACTTTCTCTAATAGAATATAC	malariae_brasilianum
AACTTTTAGCCCAATAGAATAGAAACAGATG	ovale
ATATTTACCTTTATCATGGATATCAGGTTTA	ovale
AGCAGGTTTATTAATTGTTTTAGCGTCATTA	ovale
CAGATATTAATGATGAAAATGTAGAATATAA	ovale
TTTTCCTTACGTACTCTAGCTATTTACACAA	ovale
TAACAGGTGGTGTTTTAATGTTACTATCAGA	ovale
TACTAACTATTTATCATTACTCAAGTCAGCA	ovale
ATTATTATTTATATGTACATTTACTTTCGGA	ovale
ATATCCAAGAATAAATAGTATTTCTTTATTA	ovale
ATTTGCTGGTGATCCTATATTATATCAACAT	ovale
ATATGTACATTTACTTTCGGAGGAACTACAG	ovale
ATATCAGGTTTAATTATATTTGCATTATTTA	ovale
AAATAATGTACCAGATATAGCATCATTAATA	ovale
ATGTTATTATTAACATTACCAGTTTTAACAG	ovale
TCAAAATGGCATTTGGTGCTAGAGAATATTC	ovale
AACCGCCAAAAATATAACGATATTATTACCG	ovale
AGATATATGCATGCAACTGGTGCATCATTAG	ovale
AATATGATATTTACAATTCATGGAATTATTA	ovale
ACCGCCAAAAATATAACGATATTATTACCGT	ovale
TAGTCTATATGAAGGTTTTCTATGGAAACAC	ovale
TATGCTTTATTATGGATTGGATGTCAGTTAC	vivax_simium
ATGACCATTCACTATTAGTATCATACATTTC	vivax_simium
CAAGTAAGTATATTATAAATACAATACTAGA	vivax_simium
TAATAGGATTGAATGTAAATAAGATACCCAC	vivax_simium
TTAACACAATATTATTGTCTATACTAGATAC	vivax_simium
TTTTAGCAAGTCGTTATACTCCAGAAATATC	vivax_simium
AGGTGTATTTTTAGCAAGTCGTTATACTCCA	vivax_simium
GACATCCTGAAGTGTATATTTTAATATTACC	vivax_simium
ATGCACTTGCTAAAATAAATGTAATAGTTAG	vivax_simium
AGTTAGAATTAACATTCTTGATGATGTTAAA	vivax_simium
ATATTTATATTTACCATTATCATGGATATCA	vivax_simium
TATTTGGAGGATTCGGTAATTACTTCCTACC	vivax_simium
AATGCTATTATTAACATTACCTGTTTTAACA	vivax_simium
TCTCCAAGTAAGTATATTATAAATACAATAC	vivax_simium
ATACTATAGTTGAAACAGGACATATACATAT	vivax_simium
AATTATTCATATTTATATTTACCATTATCAT	vivax_simium
CTTGCTAAAATAAATGTAATAGTTAGAATTA	vivax_simium
GCTTTATTATGGATTGGATGTCAGTTACCAC	vivax_simium
ATTGAATGTAAATAAGATACCCACAGAAAAA	vivax_simium
TAGTATCATACATTTCAACTATTCTTATAAA	vivax_simium
